S.#######################################
..#.......#...#.#.......#.......#...#...#
#.#.#.###.#.###.###.#.#.#.#.#.###.###.#.#
#.#.#...#.#.......#.#.#.#.#.#.#.....#.#.#
#.#.#######.#.###.###.#####.#.#####.###.#
#.#.#...#...#.#.#.....#.....#...#.#...#.#
#.#.#.###.#.###.#####.#####.#####.###.#.#
#.....#...#.#...........#.#...#.#...#...#
#.#.#.#.#.###.#.#####.###.###.#.###.###.#
#.#.#.#.#.#...#...#.#...#...#...#.......#
#####.#########.###.#.#####.#.#######.#.#
#.......#.....#.....#.#.......#...#...#.#
#.#.#########.#.#######.#####.#.###.#.#.#
#.#.....#...#.#...#...#...#.......#.#.#.#
#####.#.#.###.#.#.#.###.#.#####.###.#####
#.....#...#...#.#.#.....#.....#.#.......#
#.#####.#.#.#.#.#.#############.#.#.###.#
#.....#.#.#.#.#.#...........#.#...#...#.#
#.#.#####.#.#.#.###.#.#.###.#.#.###.#####
#.#.#.#...#.#.#.#.#.#.#.#.#.#...#.#.....#
#####.#.#.#.#####.#.#####.###.#.#.###.#.#
#...#...#.........#.#...#.#...#...#...#.#
#.#####.#.###.#.#.#.###.#.#.#######.#.#.#
#.......#.#.#.#.#.........#.#.......#.#.#
#.#.#.###.#.###.#####.#########.###.#.###
#.#.#.#.....#...#...#.#.#.#.....#...#...#
###########.#.#####.#.#.#.###.#.#.###.###
#.#.......#.#.......#.#.#...#.#.#.#.#.#.#
#.###.#############.###.#.#.#.#####.#.#.#
#.....#.......#.......#...#.#...#.#.#.#.#
###.#.#####.#######.###.#####.###.#.#.#.#
#...#.........#.......#.........#.......#
###.###.#.#.#.#.#.#####.#####.#####.#.#.#
#...#.#.#.#.#.#.#...........#...#.#.#.#.#
#.###.#####.###.#######.#######.#.#######
#.#...#...#...........#.....#.#.......#.#
#.###.#.###.###########.###.#.#.#####.#.#
#.#.....#...#.#.#.........#.#.....#.....#
#.#.#.###.#.#.#.###.###.#########.###.#.#
#.#.#.....#.....#...#.......#.....#...#.#
#######################################E#
